MMMMMMMMMMMMMMMMMMMMMMMMMMMMMMMMM
MDDDDDDMDDDDDDDDDDDDDDDDDDDDDDDMM
MDDDDDDMDDDDDDDDDDDDDDDDDDDDDDDMM
MDDDCDDMDDDMDDDDDDDDMMMMDDDDDDDMM
MDDDDDDMDDDMDDDDDDDDDDDDMDDDDDDMM
MDDDDDDMDDDMDDDDMMMMMMDDMDDDDDDMM
MMMMMDMMDDDMDDDDDDDDDDDDMDDDDDDMM
MDDDDDDMDDDMDDDDDDMMMMDDMDDDDDDMM
MDDMDDDMDDDMDDDDDDDDDDDDDMDDDDDMM
MDDMDCDMDDDMDDDDDDDDDMMDDDDDDDDMM
MDDMDDDMDDDMDDDDDDDDDCMDDDDDDDDMM
MDDMMMMMDDDMDDDDDDDDDMMDDDDDDDDMM
MDDDDDDDDDDMDDDDDDDDDDDDDDDDDDDMM
MMMMMMMMMMMMMMDDMMMMMMMMMMMMMMMMM
MDDDDDDDDDDDDDDDMDDDDDDDDDDDDDDMM
MDDMMMMMMMMMMMMMMDDDDMMMMMMMDDDMM
MDDDDDDDDDDDDDDDDDDDDMDDDDDDDDDMM
MMMMMMMMMMMMMMMMMMMMMMDDMMMMMMMMM
MDDDDDDDDDMMMDDDDDDDDMDDDDDDDDDMM
MDDDDMMMDDDDMDDDMDDDDMMMMMMMDDDMM
MDDMMDCDDDDDMDDDMDDDDDDDDDDMDDDMM
MDDDDMMMDDDDMDDDMDDDMMMMMMMMDDDMM
MDDDDDDDDDDDDDDDMDDDDDDDDDDDDDDMM
MMMMMMMMMMMMMMMPMMMMMMMMMMMMMMMMM
