VVVVVVVVVVVVVVVVVVVVVVVVVVVVVVVV
VGGGGGGNNNNNNNGGGGGGGGGGGGGGGGGV
VGMMDMMGNNPNNGGTGTGGGGNGNGGGGGGV
VGMDCDMGGNRNGGGTGTGGGNGGGNGGGGGV
VGDDDDDGGGRGTGGTTGGGNNNGGGNGGGGV
VGMDDDMGGGRGGGGGGGGTGNGGNGGNGGGV
VGMMDMMGGGRGGGGGGGGGGGNGGNNGGGGV
VGGGRGGGGGRGTGGGTGGGGGGGNWWNGGGV
VGGGRGGGGGRGGGGTGTGGGGGGGWNGGGGV
VGGGRGGGGGRGTGGGGGGGTGGGWWGGGGGV
VGGGRRRRRRRRRRRRRRRRRRGGWGGGGGGV
VGGGGGGGGGGGGGRGGGGGTRRRARRRRRRV
VGGGGGGGGGGGGGRGGGGGGGGGWGGRGGGV
VWWWWWWWWWWWWWBWWWWWWWWWWWWBWWWV
VGGGGGGGGGGGGGRGGGGGGGGGGGGRGGGV
VGMDMDDMDMGGGGRGGGGGGGGGGGGRGGGV
VGDDDDCDDDGGTGRGGGGTGGGGGGGRGGGV
VGMDDDDDDMGGGGRTGGGGGGTGGGGRNNNV
VGDDDDDDDDRRRRRRRRGGGTGGGWWBWWNV
VGMDDCDDDMGTGGGGTRGGGGGGGWDDDWNV
VGDDDDDDDDGGGGGGGRRRRRRRRADSDARV
VGMDMDDMDMGGGGGGGGGGGGGGNWDDDWNV
VGGGGGGGGGGGGGGGGGGGGGGNNWWWWWNV
VVVVVVVVVVVVVVVVVVVVVVVVVVVVVVVV
