MMMMMMMMMMMMMMMMMMMMMMMMMMMMMMMMM
MDDDDDDMDDDDDDDDDDDDDDDDDDDDDDDMM
MDDDDDDMDDDDDDDDDDDDDDDDDDDDDDDMM
MDDDCDDMDDDMDDDDDDDDDDDDDDDDDDDMM
MDDDDDDMDDDMDDDDDDDDDDDDDDDDDDDMM
MDDDDDDMDDDMDDDDDDDDDDDDDDDDDDDMM
MMMMMDMMDDDMDDDDDDDDDDDDDDDDDDDMM
MDDDDDDMDDDMDDDDDDDDDDDDDDDDDDDMM
MDDMDDDMDDDMDDDDDDDDDDDDDMDDDDDMM
MDDMDDDMDDDMDDDDDDDDDDDDDDDDDDDMM
MDDMDDDMDDDMDDDDDDDDDDDDDDDDDDDMM
MDDMMMMMDDDMDDDDDDDDDDDDDDDDDDDMM
MDDDDDDDDDDMDDDDDDDDDDDDDDDDDDDMM
MMMMMMMMMMMMMMDDMMMMMMMMMMMMMMMMM
MDDDDDDDDDDDDDDDMDDDDDDDDDDDDDDMM
MDDMMMMMMMMMMMMMMDDDDMMMMMMMDDDMM
MDDDDDDDDDDDDDDDDDDDDMDDDDDDDDDMM
MMMMMMMMMMMMMMMMMMMMMMDDMMMMMMMMM
MDDDDDDDDDDDDDDDDDDDDMDDDDDDDDDMM
MDDDDDDDDDDDDDDDMDDDDMMMMMMMDDDMM
MDDDDDDDDDDDDDDDMDDDDDDDDDDMDDDMM
MDDDDDDDDDDDDDDDMDDDMMMMMMMMDDDMM
MDDDDDDDDDDDDDDPMDDDDDDDDDDDDDDMM
MMMMMMMMMMMMMMMMMMMMMMMMMMMMMMMMM
