VVVVVVVVVVVVVVVVVVVVVVVVVVVVVVVV
VGGGGGGNNNNNNNGGGGGGGGGGGGGGGGGV
VGMMDMMGNNPNNGGTGTGGGGNGNGGGGGGV
VGMDCDMGGNRNGGGTGTGGGNGGGNGGGGGV
VGDDDDDGGGRGTGGTTGGGNNNGGGNGGGGV
VGMDDDMGGGRGGGGGGGGTGNGGNGGNGGGV
VGMMDMMGGGRGGGGGGGGGGGNGGNNGGGGV
VGGGRGGGGGRGTGGGTGGGGGGGNWWNGGGV
VGGGRGGGGGRGGGGTGTGGGGGGGWNGGGGV
VGGGRGGGGGRGGGGGGGGGTGGGWWGGGGGV
VGGGRRRRRRRRRRRRRRRRRRGGWGGGGGGV
VGGGGGGGGGGGGGRGGGGGTRRRARRRRRRV
VGGGGGGGGGGGGGRGGGGGGGGGWGGRGGGV
VWWWWWWWWWWWWWBWWWWWWWWWWWWBWWWV
VGGGGGGGGGGGGGRGGGGGGGGGGGGRGGGV
VGMDMDDMDMGGGGRGGGGGGGGGGGGRGGGV
VGDDDDDDDDGGTGRGGGGTGGGGGGGRGGGV
VGMDDDDDDMGGGGRTGGGGGGTGGGGRNNNV
VGDDDDDDDDRRRRRRRRGGGTGGGWWBWWNV
VGMDDDDDDMGTGGGGTRGGGGGGGWDDDWNV
VGDDDDDDDDGGGGGGGRRRRRRRRADSDARV
VGMDMDDMDMGGGGGGGGGGGGGGNWDDDWNV
VGGGGGGGGGGGGGGGGGGGGGGNNWWWWWNV
VVVVVVVVVVVVVVVVVVVVVVVVVVVVVVVV
