MMMMMMMMMMMMMMMMMMMMMMMMMMMMMMMMM
MDDDDDDMDDDDDDDDDDDDDDDDDDDDDDDMM
MDDDDDDMDDDDDDDDDDDDDDDDDDDDDDDMM
MDDDCDDMDDDDDDDDDDDDDDDDDDDDDDDMM
MDDDDDDMDDDDDDDDDDDDDDDDDDDDDDDMM
MDDDDDDMDDDDDDDDDDDDDDDDDDDDDDDMM
MMMMMDMMDDDDDDDDDDDDDDDDDDDDDDDMM
MDDDDDDDDDDDDDDDDDDDDDDDDDDDDDDMM
MDDDDDDDDDDDDDDDDDDDDDDDDMDDDDDMM
MDDDDDDDDDDDDDDDDDDDDDDDDDDDDDDMM
MDDDDDDDDDDDDDDDDDDDDDDDDDDDDDDMM
MDDDDDDDDDDDDDDDDDDDDDDDDDDDDDDMM
MDDDDDDDDDDDDDDDDDDDDDDDDDDDDDDMM
MMMMMMMMMMMMMMDDMMMMMMMMMMMMMMMMM
MDDDDDDDDDDDDDDDDDDDDDDDDDDDDDDMM
MDDDDDDDDDDDDDDDDDDDDDDDDDDDDDDMM
MDDDDDDDDDDDDDDDDDDDDDDDDDDDDDDMM
MDDDDDDDDDDDDDDDDDDDDDDDDDDDDDDMM
MDDDDDDDDDDDDDDDDDDDDDDDDDDDDDDMM
MDDDDDDDDDDDDDDDDDDDDDDDDDDDDDDMM
MDDDDDDDDDDDDDDDDDDDDDDDDDDDDDDMM
MDDDDDDDDDDDDDDDDDDDDDDDDDDDDDDMM
MDDDDDDDDDDDDDPDDDDDDDDDDDDDDDDMM
MMMMMMMMMMMMMMMMMMMMMMMMMMMMMMMMM
