MMMMMMMMMMMMMMMMMMMMMMMMMMMMMMMMM
MDDDDDDMDDDDDDDDDDDDDDDDDDDDDDDDM
MDDDDDDMDDDDDDDDDDDDDDDDDDDDDDDDM
MDDDCDDMDDDDDDDDDDDDDDDDDDDDDDDDM
MDDDDDDMDDDDDDDDDDDDDDDDDDDDDDDDM
MDDDDDDMDDDDDDDDDDDDDDDDDDDDDDDDM
MMMMMDMMDDDDDDDDDDDDDDDDDDDDDDDDM
MDDDDDDDDDDDDDDDDDDDDDDDDDDDDDDDM
MDDDDDDDDDDDDDDDDDDDDDDDDMDDDDDDM
MDDDDDDDDDDDDDDDDDDDDDDDDDDDDDDDM
MDDDDDDDDDDDDDDDDDDDDDDDDDDDDDDDM
MDDDDDDDDDDDDDDDDDDDDDDDDDDDDDDDM
MDDDDDDDDDDDDDDDDDDDDDDDDDDDDDDDM
MMMMMMMMMMMMMMDDMMMMMMMMMMMMMMMMM
MDDDDDDDDDDDDDDDDDDDDDDDDDDDDDDDM
MDDDDDDDDDDDDDDDDDDDDDDDDDDDDDDDM
MDDDDDDDDDDDDDDDDDDDDDDDDDDDDDDDM
MDDDDDDDDDDDDDDDDDDDDDDDDDDDDDDDM
MDDDDDDDDDDDDDDDDDDDDDDDDDDDDDDDM
MDDDDDDDDDDDDDDDDDDDDDDDDDDDDDDDM
MDDDDDDDDDDDDDDDDDDDDDDDDDDDDDDDM
MDDDDDDDDDDDDDDDDDDDDDDDDDDDDDDDM
MDDDDDDDDDDDDDPDDDDDDDDDDDDDDDDDM
MMMMMMMMMMMMMMMMMMMMMMMMMMMMMMMMM
