MMMMMMMMMMMMMMMMMMMMMMMMMMMMMMMM
MDDDDDMDDDDDDDDDDDDDDDDDDDDDDDDM
MDDDDDMDDDDDDDDDDDDDDDDDDDDDDDDM
MDDCDDMDDDDDDDDDDDDDDDDDDDDDDDDM
MDDDDDMDDDDDDDDDDDDDDDDDDDDDDDDM
MDDDDDMDDDDDDDDDDDDDDDDDDDDDDDDM
MMMMDMMDDDDDDDDDDDDDDDDDDDDDDDDM
MDDDDDDDDDDDDDDDDDDDDDDDDDDDDDDM
MDDDDDDDDDDDDDDDDDDDDDDDMDDDDDDM
MDDDDDDDDDDDDDDDDDDDDDDDDDDDDDDM
MDDDDDDDDDDDDDDDDDDDDDDDDDDDDDDM
MDDDDDDDDDDDDDDDDDDDDDDDDDDDDDDM
MDDDDDDDDDDDDDDDDDDDDDDDDDDDDDDM
MMMMMMMMMMMMMDDMMMMMMMMMMMMMMMMM
MDDDDDDDDDDDDDDDDDDDDDDDDDDDDDDM
MDDDDDDDDDDDDDDDDDDDDDDDDDDDDDDM
MDDDDDDDDDDDDDDDDDDDDDDDDDDDDDDM
MDDDDDDDDDDDDDDDDDDDDDDDDDDDDDDM
MDDDDDDDDDDSDDDDDDDDDDDDDDDDDDDM
MDDDDDDDDDDDDDDDDDDDDDDDDDDDDDDM
MDDDDDDDDDDDDDDDDDDDDDDDDDDDDDDM
MDDDDDDDDDDDDDDDDDDDDDDDDDDDDDDM
MDDDDDDDDDDDDDPDDDDDDDDDDDDDDDDM
MMMMMMMMMMMMMMMMMMMMMMMMMMMMMMMM
