VVVVVVVVVVVVVVVVVVVVVVVVVVVVVVVV
VGGGGGGGGGGGGGGGGGGGGGGGGGGGGGGV
VGMMMMMGGGGGGGGTGTGGGGNGNGGGGGGV
VGMDCDMGGGGGGGGTGTGGGNGGGNGGGGGV
VGMDDDMGGGGGTGGTTGGGNGNGGGNGGGGV
VGMDDDMGGGGGGGGGGGGTGNGGNGGNGGGV
VGMMPMMGGGGGGGGGGGGGGGNGGNNGGGGV
VGGGRGGGGGGGTGGGTSGGGGGGNWWNGGGV
VGGGRGGGGGGGGGGTGTGGGGGGGWNGGGGV
VGGGRGGGGGGGGGGGGGGGTGGGWWGGGGGV
VGGGRRRRRRRRRRRRRRRRRRGGWGGGGGGV
VGGGGGGGGGGGGGRGGGGGTRRRARRRRRRV
VGGGGGGGGGGGGGRGGGGGGGGGWGGGGGGV
VWWWWWWWWWWWWWBWWWWWWWWWWWWWWWWV
VGGGGGGGGGGGGGRGGGGGGGGGGGGGGGGV
VGMMMMMMMMGGGGRGGGGGGGGGGGGGGGGV
VGMDDDDDDMGGTGRGGGGTGGGGGGGGGGGV
VGMDDDDDDMGGGGRTGGGGGGTGGGGGGGGV
VGMDDDDDDPRRRRRGGGGGGTGGGGGGGGGV
VGMDDDDDDMGTGGGGTGGGGGGGGGGGGGGV
VGMDDDDDDMGGGGGGGGGGGGGGGGGGGGGV
VGMMMMMMMMGGGGGGGGGGGGGGGGGGGGGV
VGGGGGGGGGGGGGGGGGGGGGGGGGGGGGGV
VVVVVVVVVVVVVVVVVVVVVVVVVVVVVVVV
