MMMMMMMMMMMMMMMMMMMMMMMMMMMMMMMM
MGGGGGGGGGGGGGGGGGGGGGGGGGGGGGGM
MGMMMMMGGGGGGGGTTTGGGGGGGGGGGGGM
MGMDCDMGGGGGGGGTTTGGGGGGGGGGGGGM
MGMDDDMGGGGGGGGTTTGGGGGGGGGGGGGM
MGMDDDMGGGGGGGGGGGGGGGGGGGGGGGGM
MGMMPMMGGGGGGGGGGGGGGGGGGGGGGGGM
MGGGRGGGGGGGGGGGGSGGGGGGGGGGGGGM
MGGGRGGGGGGGGGGGGGGGGGGGGGGGGGGM
MGGGRGGGGGGGGGGGGGGGGGGGGGGGGGGM
MGGGRRRRRRRRRRRGGGGGGGGGGGGGGGGM
MGGGGGGGGGGGGGRGGGGGGGGGGGGGGGGM
MGGGGGGGGGGGGGRGGGGGGGGGGGGGGGGM
MWWWWWWWWWWWWWBWWWWWWWWWWWWWWWWM
MGGGGGGGGGGGGGGGGGGGGGGGGGGGGGGM
MGGGGGGGGGGGGGGGGGGGGGGGGGGGGGGM
MGGGGGGGGGGGGGGGGGGGGGGGGGGGGGGM
MGGGGGGGGGGGGGGGGGGGGGGGGGGGGGGM
MGGGGGGGGGGGGGGGGGGGGGGGGGGGGGGM
MGGGGGGGGGGGGGGGGGGGGGGGGGGGGGGM
MGGGGGGGGGGGGGGGGGGGGGGGGGGGGGGM
MGGGGGGGGGGGGGGGGGGGGGGGGGGGGGGM
MGGGGGGGGGGGGGGGGGGGGGGGGGGGGGGM
MMMMMMMMMMMMMMMMMMMMMMMMMMMMMMMM